+--+--+--+--+--+--+--+--+--+--+--+--+--+--+--+
S  |              |     |     |     |        |
+  +  +--+--+--+  +  +  +  +  +--+  +--+--+  +
|  |           |  |  |     |  |        |     |
+  +--+--+--+  +  +  +--+--+  +  +--+  +  +--+
|  |           |     |        |  |  |  |     |
+  +  +--+--+--+--+--+  +--+--+  +  +  +  +  +
|     |     |           |     |  |        |  |
+--+--+  +--+  +--+--+--+  +  +  +--+--+--+  +
|     |                 |  |     |        |  |
+  +--+--+  +--+--+--+--+  +--+--+  +  +  +  +
|        |  |     |     |     |     |  |     |
+  +  +--+  +--+  +  +  +--+  +  +--+--+--+  +
|  |           |     |     |  |  |     |     |
+  +--+--+  +  +--+--+--+  +  +  +  +  +--+--+
|  |  |     |              |  |     |  |     |
+  +  +  +--+--+--+--+--+  +  +--+--+  +  +  +
|     |  |     |        |  |  |     |     |  |
+--+--+  +  +  +  +--+  +  +  +--+  +  +--+  +
|     |  |  |  |  |     |     |     |     |  |
+  +  +  +  +  +  +  +--+--+--+  +  +--+--+  +
|  |     |  |     |           |  |  |        |
+  +--+--+  +--+--+--+--+--+  +  +--+  +--+--+
|     |     |              |  |        |     |
+--+  +  +--+  +--+--+--+  +  +--+--+--+--+  +
|  |     |  |  |     |     |     |     |     |
+  +--+--+  +  +  +  +  +  +--+  +--+  +  +--+
|        |     |  |     |           |     |  |
+  +--+  +--+--+--+--+--+--+--+  +  +  +--+  +
|     |                          |           F
+--+--+--+--+--+--+--+--+--+--+--+--+--+--+--+