+-+-+-+-+-+-+-+-+-+-+-+-+-+-+-+
S |         |   |   |   |     |
+ + +-+-+-+ + + + + +-+ +-+-+ +
| |       | | |   | |     |   |
+ +-+-+-+ + + +-+-+ + +-+ + +-+
| |       |   |     | | | |   |
+ + +-+-+-+-+-+ +-+-+ + + + + +
|   |   |       |   | |     | |
+-+-+ +-+ +-+-+-+ + + +-+-+-+ +
|   |           | |   |     | |
+ +-+-+ +-+-+-+-+ +-+-+ + + + +
|     | |   |   |   |   | |   |
+ + +-+ +-+ + + +-+ + +-+-+-+ +
| |       |   |   | | |   |   |
+ +-+-+ + +-+-+-+ + + + + +-+-+
| | |   |         | |   | |   |
+ + + +-+-+-+-+-+ + +-+-+ + + +
|   | |   |     | | |   |   | |
+-+-+ + + + +-+ + + +-+ + +-+ +
|   | | | | |   |   |   |   | |
+ + + + + + + +-+-+-+ + +-+-+ +
| |   | |   |       | | |     |
+ +-+-+ +-+-+-+-+-+ + +-+ +-+-+
|   |   |         | |     |   |
+-+ + +-+ +-+-+-+ + +-+-+-+-+ +
| |   | | |   |   |   |   |   |
+ +-+-+ + + + + + +-+ +-+ + +-+
|     |   | |   |       |   | |
+ +-+ +-+-+-+-+-+-+-+ + + +-+ +
|   |                 |       F
+-+-+-+-+-+-+-+-+-+-+-+-+-+-+-+